MMMMMMMMMMMMMMMMMMMMMMMMMMMMMMMM
MTTTTTTTTTTTRVTTTTTTTTTTTTTTTTTM
MTTPTTTTRTTTDTTTTTTTTTRTTTTVTTTM
MTTTTVTTTDTTVTTTTTTTTTTTTDTTTTTM
MTTTTTTTRTTTTTTTTTTVTTTRTTTTTTTM
MTTTTTTTTTTTVTTTTTTTTTTTTTTTVTTM
MTTTTTTTVTTTTTTTTTTTTTDTTTTTTTTM
MTTTTTTTRTTTTTTTVTTTRTTTTTTTTTTM
MTTTTTTTTTTTTTRTTTTTTTTTTDTTTTTM
MTTTTTTTTVTTTTTTTTTTVTTTTTTTTTTM
MTTTTRTTTTTTTDTTTRTTTTDTTTTTTTTM
MTTVTTTTTTTTTTTTTTTTTTTTTTVTTTTM
MTTTTTTTTTRTTTTTTVTTTTTTTTTTTTTM
MTTTTTTVTTTTTDTTTTTTTRTTTTTTTTTM
MTTTTTTTRTTTTTTVTTTTTDTTTTTVTTTM
MMMMMMMMMMMMMMMMMMMMMMMMMMMMMMMM